WWWWWWWWWWWWWWWWWWW
WppppppppWppppppppW
WBWWpWWWpWpWWWpWWBW
WpppppppppppppppppW
WpWWpWpWWWWWpWpWWpW
WppppWpppWpppWppppW
WWWWpWWW W WWWpWWWW
   WpW   G   WpW   
WWWWpW WW WW WpWWWW
    p  WGGGW  p    
WWWWpW WWWWW WpWWWW
   WpW       WpW   
WWWWpW WWWWW WpWWWW
WppppppppWppppppppW
WpWWpWWWpWpWWWpWWpW
WBpWpppppPpppppWpBW
WWpWpWpWWWWWpWpWpWW
WppppWpppWpppWppppW
WpWWWWWWpWpWWWWWWpW
WpppppppppppppppppW
WWWWWWWWWWWWWWWWWWW