Z               XXX
7--------2--------9
|pppppppp|pppppppp|
|S<>p<->pvp<->p<>S|
|ppppppppppppppppp|
|p<>p^p<-2->p^p<>p|
|pppp|ppp|ppp|pppp|
1--9p6-> v <-4p7--3
   |p|   B   |p|   
<--3pv 7-G-9 vp1-->
   Wp  |IPC|  pW   
<--9p^ 1---3 ^p7-->
   |p|       |p|   
7--3pv <-2-> vp1--9
|pppppppp|pppppppp|
|p<9p<->pvp<->p7>p|
|Sp|pppppMppppp|pS|
6>pvp^p<-2->p^pvp<4
|pppp|ppp|ppp|pppp|
|p<--8->pvp<-8-->p|
|ppppppppppppppppp|
1-----------------3