WWWWWWWWWWWWWWWWWWW
WppppppppWppppppppW
WSWWpWWWpWpWWWpWWSW
WpppppppppppppppppW
WpWWpWpWWWWWpWpWWpW
WppppWpppWpppWppppW
WWWWpWWW W WWWpWWWW
   WpW   B   WpW   
WWWWpW WW WW WpWWWW
    p  WIPCW  p    
WWWWpW WWWWW WpWWWW
   WpW       WpW   
WWWWpW WWWWW WpWWWW
WppppppppWppppppppW
WpWWpWWWpWpWWWpWWpW
WSpWpppppMpppppWpSW
WWpWpWpWWWWWpWpWpWW
WppppWpppWpppWppppW
WpWWWWWWpWpWWWWWWpW
WpppppppppppppppppW
WWWWWWWWWWWWWWWWWWW